YYMY-YYYYY
RRRRRRRVRR
BA--BBBBBB
XXXXXX-XX-
GGGGGVGGGG