YYYY-YYYYY
RRRRRRRRRR
BB--BBBBBB
XXXXXX-XX-
GGGGGGGGGG