Y Y Y Y - Y Y Y Y Y
R R R R R R R R R R
B B - - B B B B B B
X X X X X X - X X -
G G G G G G G G G G
